# num rows, num cols
22, 30
# cost targets (min score target, max score target)
18.4, 9.2
# nodes targets (min score target, max score target)
20, 13
# UCS run time targets (min score target, max score target)
0.0020, 0.0012
# A* run time targets (min score target, max score target)
0.0014, 0.0007
# grid data
XXXXXXXXXXXXXXXXXXXXXXXXXXXXXX
X    L         GXL          =X
X       =XXXDXXXXXXXTXXXXXXX=X
X=XTTXXX=XXX XXXXLXX XXXXXXX=X
X=      =                   =X
X=  XXDXXXXXXXDXXXXXX=XXXXXXXX
X=XXXX XXXXXXLXL     =      LX
X=            XXXXTXX=XXTXXXXX
X=XXXXXXDXXXXXXXXX XX=XX XXXXX
X=            P      =       X
XXXX=XTXXXX=XXXXXXXXDXXXTX=XXX
XL  =X XXXX= XL     =XXX X=  X
X   =X     = XXXXXXX=XXX X=  X
XXXXXXXXXXX=XX LXXXX=XXX X=  X
XXXLXXXXXXX=    X   =XXX X= LX
XXX        =XTXXX=XX=XXX XXXXX
XXXXXXDXXX = X   =XX=XXX    LX
XL         = XL  =XX=XXX     X
XXXXXXTXXXX= XXTXXXX=XXX=XXXXX
XLXXXX XXXX= XX XXXX=XXX=XXXXX
X          =        =   =   LX
XXXXXXXXXXXXXXXXXXXXXXXXXXXXXX
# Schematic

     0           A
            1       C
   E0            3

      2       8
             2 7            C
                  4     5
        9

      3             6   F
 4            6

               5
   E                        B
             B
      D                     1
 8            9
      7        A
 D
                            F
